TILEMAP
16 16 					-- Size of tile map in tiles
16 16				-- Tile size & block size
images/tilesheet.png 	-- Tilesheet
16 16		-- Number of tiles in tilesheet

23 37 30 30 44 30 30 38 38 38 38 38 39 56 56 29
30 23 37 38 38 38 39 56 56 56 56 56 56 56 56 29
30 30 23 45 56 56 56 56 56 56 56 56 56 56 3 29
38 38 39 56 56 56 56 56 56 56 56 56 2 45 45 29
23 5 6 56 56 56 56 56 56 56 56 56 46 47 22 30
31 13 14 56 56 56 56 56 56 56 56 56 56 56 37 30
30 22 47 47 48 56 56 56 56 56 56 56 56 56 56 29
30 39 56 56 56 56 56 56 56 56 56 56 56 56 56 29
31 56 56 56 56 56 56 56 56 56 56 56 56 56 56 29
39 56 56 56 56 56 56 56 56 56 56 56 56 46 22 30
56 56 56 56 56 56 56 1 56 56 56 56 56 56 29 30
64 64 64 64 64 64 64 21 23 64 64 64 64 64 29 30
64 64 64 21 23 64 64 37 39 64 64 4 4 4 29 30
22 22 22 30 31 64 64 21 23 4 4 21 22 22 30 30
30 44 30 30 31 4 4 29 30 22 22 30 30 30 44 30
30 30 30 30 30 22 22 30 30 30 30 30 30 30 30 30
