TILEMAP
18 198					-- Size of tile map in tiles
24 24				-- Tile size & block size
images/tilesheet.png 	-- Tilesheet
8 8		-- Number of tiles in tilesheet
0 0 0 0 0 0 0 0 0 0 0 0 0 0 0 0 0 0 
0 0 0 0 0 0 0 0 0 0 0 0 0 0 0 0 0 0 
0 0 0 0 0 0 0 0 51 0 0 52 51 0 0 0 0 0 
0 0 0 0 0 55 52 53 0 0 0 50 0 0 0 3 0 0 
0 0 0 0 52 52 52 51 0 0 0 0 0 2 0 0 0 0 
0 0 0 52 53 52 51 42 52 43 0 0 0 0 0 0 0 0 
0 0 42 52 52 52 52 52 51 0 0 0 0 0 0 0 0 0 
0 0 0 0 0 0 52 52 0 0 0 0 0 0 0 52 0 0 
0 0 0 53 52 52 51 0 0 0 0 0 0 0 0 53 0 0 
0 0 0 0 50 52 0 0 0 0 42 52 42 52 52 52 0 0 
0 0 0 0 0 52 54 0 0 0 52 55 52 52 0 0 0 0 
0 0 0 0 42 52 52 53 1 42 52 52 52 53 52 0 0 0 
0 0 0 0 52 53 52 52 0 0 52 0 0 50 52 0 0 0 
0 0 0 42 0 0 52 50 0 0 51 0 0 0 0 0 0 0 
0 0 0 0 0 0 51 0 0 0 0 0 0 0 0 0 0 0 
0 0 0 0 0 0 0 0 0 0 0 0 0 0 0 0 0 0 
0 0 0 0 0 0 0 0 0 0 0 0 0 0 0 0 0 0 
0 0 0 0 0 0 0 0 0 0 0 0 0 0 0 0 0 0 
0 0 0 0 0 0 0 0 0 0 0 0 0 0 0 0 0 0 
0 0 0 0 0 0 0 0 0 0 0 0 0 52 52 52 0 0 
0 0 0 0 0 0 0 52 52 0 52 0 0 50 55 52 0 0 
0 0 0 0 0 55 52 51 51 0 52 0 0 0 42 53 0 0 
0 0 0 0 52 52 51 0 0 0 50 0 0 0 0 50 0 0 
0 0 0 0 51 0 0 0 0 0 0 0 0 0 0 0 0 0 
0 0 0 0 0 0 0 0 0 0 0 0 0 0 0 1 0 0 
0 0 0 3 0 42 43 0 0 0 0 0 0 0 0 0 0 0 
0 0 0 0 0 52 51 0 0 43 0 0 0 0 0 0 0 0 
0 0 0 0 0 52 43 0 0 52 54 43 0 42 52 0 0 0 
0 0 0 0 0 52 52 52 0 52 52 52 53 52 52 0 0 0 
0 0 0 0 0 0 50 52 0 51 0 50 52 52 0 0 0 0 
0 0 0 0 0 0 42 52 0 0 0 0 0 50 52 52 0 0 
0 0 52 0 0 42 53 51 0 0 0 0 0 0 0 50 0 0 
0 0 50 53 0 52 51 0 0 0 0 0 0 0 0 42 52 0 
0 0 0 50 52 52 54 2 0 0 0 0 54 0 42 53 52 0 
0 0 0 0 0 0 0 0 0 0 0 0 52 52 52 52 52 0 
0 0 0 0 0 0 0 0 0 0 0 0 0 0 0 0 0 0 
0 0 0 0 0 0 0 0 0 0 0 0 0 0 0 0 0 0 
0 0 0 0 0 0 0 0 0 52 53 52 52 0 0 0 0 0 
0 0 0 0 0 0 0 0 50 52 52 51 52 55 0 0 0 0 
0 0 0 0 0 0 0 0 0 0 0 0 50 0 0 0 0 0 
0 0 0 0 0 0 0 0 0 0 0 0 0 0 0 0 0 0 
0 0 0 0 0 0 3 2 0 0 0 0 0 0 0 0 0 0 
0 0 0 0 0 0 0 0 0 0 0 0 0 0 0 0 0 0 
0 0 0 0 0 0 0 0 0 0 0 0 0 0 0 0 41 0 
0 0 0 0 42 0 0 0 0 0 0 0 54 0 0 0 49 0 
0 0 0 0 52 52 52 52 52 0 0 52 52 52 43 0 0 0 
0 0 0 42 52 53 52 55 51 0 0 50 52 53 52 0 0 0 
0 0 0 0 50 52 52 52 0 0 0 0 52 55 52 0 0 0 
0 0 0 0 0 0 50 52 0 0 0 0 52 52 52 0 0 0 
0 0 0 0 0 0 0 52 0 0 0 0 51 50 0 0 0 0 
0 0 0 2 0 0 0 50 52 0 0 51 0 0 0 0 0 0 
0 0 0 0 0 0 0 0 50 0 0 0 0 0 0 0 0 0 
0 0 0 0 0 0 0 0 0 0 0 0 0 0 0 0 0 0 
0 0 0 0 0 0 0 0 0 0 0 0 0 0 0 0 0 0 
0 0 0 0 0 0 0 0 0 0 0 0 0 0 0 0 0 0 
0 0 0 0 0 0 35 35 35 0 0 0 0 0 0 0 0 0 
0 52 52 52 51 0 0 0 0 52 52 51 0 0 0 0 0 0 
0 52 53 51 0 0 42 43 42 53 52 0 0 0 0 0 0 0 
0 51 0 0 0 0 0 0 0 52 52 0 0 0 0 0 0 0 
0 0 0 0 42 42 0 0 0 0 52 43 0 0 0 0 0 0 
0 43 0 0 52 52 52 0 0 52 51 0 0 0 0 0 0 0 
0 52 53 52 52 52 53 0 0 52 0 0 0 0 0 0 0 0 
0 52 52 52 52 55 52 0 0 51 0 0 0 0 0 0 0 0 
0 52 51 0 50 52 52 0 0 0 0 0 0 0 0 0 0 0 
0 50 0 0 0 52 53 0 0 0 0 0 0 0 0 0 0 0 
0 0 0 0 0 50 52 0 0 0 0 0 0 0 0 0 0 0 
0 0 0 0 42 52 52 0 0 0 0 0 0 0 0 0 0 0 
0 1 0 42 53 52 51 50 0 0 0 0 0 0 0 0 0 0 
0 0 0 0 0 51 0 0 0 0 0 0 0 0 0 0 0 0 
0 0 0 0 0 0 0 0 0 0 0 0 0 0 0 0 0 0 
0 0 0 0 0 0 0 0 0 0 0 0 0 0 0 0 0 0 
0 0 0 0 0 0 0 0 0 0 0 0 0 0 0 0 0 0 
0 0 0 0 0 0 0 0 0 0 0 0 0 0 0 0 0 0 
0 0 0 35 35 35 0 0 0 0 0 0 0 0 0 0 0 0 
0 52 55 0 0 0 0 52 51 0 0 0 0 50 52 0 0 0 
0 53 52 0 1 0 42 52 0 0 0 0 0 0 52 0 0 0 
0 50 52 52 0 0 0 51 0 0 0 0 0 0 52 43 0 0 
0 0 55 52 52 52 51 0 0 0 0 0 0 42 52 52 0 0 
0 50 52 52 51 0 0 0 0 0 0 0 0 52 53 52 51 0 
0 0 50 0 0 0 0 0 0 0 0 0 0 55 52 51 0 0 
0 0 0 0 0 0 0 0 0 0 42 0 0 52 52 0 0 0 
0 0 0 0 0 0 0 0 53 52 52 0 0 0 0 0 0 0 
0 0 0 0 0 0 0 0 52 52 50 52 0 0 43 0 0 0 
0 0 0 0 0 0 0 0 52 0 0 0 50 52 52 43 0 0 
0 0 0 2 0 0 0 0 51 0 0 0 0 53 52 0 0 0 
0 0 0 0 0 0 0 0 0 0 0 0 3 50 52 54 0 0 
0 50 52 0 43 0 42 0 0 0 42 0 0 0 0 0 0 0 
0 0 53 0 52 43 52 0 0 0 52 43 42 0 0 0 0 0 
0 0 50 0 52 55 52 0 0 42 52 52 52 0 0 0 0 0 
0 0 0 0 0 0 0 0 0 0 0 0 0 0 0 0 0 0 
0 0 0 0 0 0 0 0 0 0 0 0 0 0 0 0 0 0 
0 0 0 0 0 0 0 0 0 0 0 0 0 52 52 0 0 0 
0 0 0 0 0 0 0 0 0 0 0 0 0 52 52 0 0 0 
0 0 0 0 0 0 0 0 0 0 0 0 0 52 52 0 0 0 
0 0 0 0 0 0 0 0 0 0 0 0 0 52 52 0 0 0 
0 0 0 0 0 0 55 0 0 0 52 52 52 52 53 0 0 0 
0 52 52 0 0 0 52 52 51 0 50 0 50 52 52 0 0 0 
0 52 52 0 0 0 52 52 0 0 0 0 0 50 0 0 0 0 
0 53 52 43 0 0 0 50 51 0 0 0 0 0 0 0 0 0 
0 52 52 52 51 0 0 0 0 0 0 42 43 42 52 52 0 0 
0 52 51 0 0 0 0 0 0 0 0 50 52 52 52 51 0 0 
0 52 0 0 0 43 52 43 0 0 0 0 0 52 52 0 0 0 
0 52 0 42 52 52 55 52 0 0 0 0 42 52 51 0 0 0 
0 0 0 0 52 52 52 52 52 43 0 42 52 53 52 3 0 0 
0 0 0 0 0 0 0 0 52 52 52 52 55 52 52 0 0 0 
0 0 0 0 0 0 0 0 50 52 52 0 0 0 0 0 0 0 
0 0 0 0 0 0 0 0 0 0 50 0 0 0 0 0 0 0 
0 0 0 0 0 0 0 0 0 0 0 0 0 0 0 0 0 0 
0 0 0 0 0 0 0 0 0 0 0 0 0 0 0 0 0 0 
0 0 0 0 0 0 0 52 52 52 52 0 0 0 0 0 0 0 
0 0 0 0 0 0 0 53 52 50 52 0 0 0 0 0 0 0 
0 0 0 0 0 52 52 52 51 0 0 50 52 0 0 0 0 0 
0 0 0 0 0 0 0 0 0 0 0 0 0 0 0 0 0 0 
0 0 0 0 0 0 0 0 0 0 0 0 0 0 0 0 0 0 
0 0 0 0 0 0 0 0 0 0 0 0 0 0 0 0 0 0 
0 0 52 43 0 0 0 0 0 0 0 0 0 0 0 52 0 0 
0 0 55 55 0 0 0 0 52 52 43 0 0 0 0 50 0 0 
0 0 53 52 0 0 0 0 55 52 0 0 0 0 0 0 0 0 
0 50 52 43 0 0 0 0 50 52 0 0 0 0 0 0 0 0 
0 0 52 51 0 0 0 0 52 52 0 0 0 0 0 0 0 0 
0 0 50 52 0 0 0 0 42 53 0 0 0 0 0 0 0 0 
0 0 42 51 0 0 0 0 52 52 0 0 0 0 0 0 0 0 
0 0 55 0 0 0 0 0 52 55 0 0 0 0 0 0 0 0 
0 42 52 0 3 0 0 0 42 52 43 0 0 0 0 0 0 0 
0 52 0 0 0 0 0 0 52 52 52 0 0 0 0 0 0 0 
0 0 0 0 0 0 0 0 0 0 0 0 0 0 0 0 0 0 
0 0 0 0 0 0 0 0 0 0 0 0 0 0 0 0 0 0 
0 0 52 52 52 52 0 0 0 0 0 0 0 0 0 0 0 0 
0 0 52 53 52 52 52 50 50 52 0 0 0 0 0 0 0 0 
0 0 52 52 52 52 51 0 0 50 52 52 52 53 52 0 0 0 
0 0 52 52 52 52 0 0 0 0 52 52 52 52 52 0 0 0 
0 0 50 52 52 0 0 0 0 50 52 52 53 52 52 0 0 0 
0 0 0 52 55 0 0 0 0 42 52 52 52 52 52 0 0 0 
0 0 0 52 52 42 43 0 42 52 52 52 51 0 50 0 0 0 
0 0 0 52 52 52 53 0 52 52 52 43 0 0 0 0 0 0 
0 0 52 52 52 52 52 42 52 52 52 52 0 0 0 0 0 0 
0 52 52 52 53 52 52 52 52 52 52 51 0 0 0 0 0 0 
0 50 52 52 52 52 55 52 52 52 52 54 0 0 0 0 0 0 
0 0 0 50 52 52 52 52 52 51 52 52 52 0 0 0 42 0 
0 0 0 50 52 52 50 51 0 0 52 55 51 0 0 50 52 0 
0 41 0 0 52 53 0 0 0 0 50 52 43 0 0 0 52 0 
0 49 0 42 52 52 0 0 0 0 0 42 52 0 0 42 52 0 
0 0 0 0 0 52 43 0 0 0 0 52 52 43 0 52 53 0 
0 0 0 0 0 0 0 0 0 0 0 0 0 0 0 0 0 0 
0 0 0 0 0 0 0 0 0 0 0 0 0 0 0 0 0 0 
0 0 0 0 0 0 0 0 0 0 0 0 0 0 0 0 0 0 
0 0 52 52 0 0 0 0 0 50 52 52 52 52 52 0 0 0 
0 0 52 43 0 0 0 0 0 0 50 53 52 0 50 0 0 0 
0 52 52 55 51 0 0 0 0 0 0 52 52 0 0 0 0 0 
0 52 52 52 0 0 0 0 0 0 50 52 52 43 0 0 0 0 
0 52 52 52 0 0 0 0 0 0 0 0 52 52 0 0 0 0 
0 52 53 52 0 0 0 0 0 0 0 42 52 51 0 0 0 0 
0 52 52 52 54 0 0 0 0 0 42 52 52 0 0 0 0 0 
0 52 52 52 52 55 51 0 0 0 0 50 52 51 0 0 52 0 
0 52 51 0 0 50 0 0 0 0 0 0 53 0 0 42 52 0 
0 52 42 0 0 0 0 0 0 0 0 0 52 0 0 52 52 0 
0 53 51 0 0 0 0 0 0 0 0 42 55 51 0 52 53 0 
0 51 0 0 0 0 0 0 0 0 0 0 50 0 0 52 51 0 
0 0 0 0 0 0 0 0 0 0 0 0 0 0 0 50 42 0 
0 0 0 0 0 0 0 0 0 0 0 0 0 0 0 0 50 0 
0 0 0 0 0 0 0 0 0 0 0 0 0 0 0 0 0 0 
0 0 0 0 0 0 0 0 0 0 0 0 0 0 0 0 0 0 
0 0 0 0 0 0 0 0 0 0 0 0 0 0 0 0 0 0 
0 0 0 0 0 0 0 0 0 0 0 0 0 0 0 0 0 0 
0 0 0 0 52 52 52 52 0 0 0 0 0 0 0 0 0 0 
0 0 0 0 52 53 52 52 0 0 53 52 51 0 0 0 0 0 
0 0 0 0 52 52 52 52 0 52 51 50 0 0 0 50 0 0 
0 0 0 0 52 51 0 52 0 43 0 0 0 0 0 0 0 0 
0 0 0 0 0 0 0 50 0 51 0 0 0 0 0 0 0 0 
0 0 0 0 0 0 0 0 51 0 0 0 0 0 0 0 42 0 
0 0 0 0 0 0 0 0 0 0 0 0 0 0 0 52 52 0 
0 0 0 0 0 0 0 0 0 0 0 0 0 0 0 52 53 0 
0 52 52 52 0 0 0 0 0 0 0 0 0 0 0 52 52 0 
0 52 53 55 51 50 0 0 0 0 0 0 0 50 0 55 52 0 
0 52 52 52 0 0 0 0 0 0 0 0 0 0 50 52 52 0 
0 52 51 50 0 0 0 0 0 0 0 0 0 0 0 52 50 0 
0 50 0 0 0 0 0 0 0 0 0 0 0 0 50 52 0 0 
0 0 0 0 0 0 0 0 0 0 0 0 0 0 0 51 0 0 
0 0 0 43 0 0 0 0 0 0 0 0 0 0 0 0 0 0 
0 42 0 53 0 0 0 0 0 0 0 0 0 0 0 0 0 0 
0 0 0 0 0 0 0 0 0 0 0 0 0 0 0 0 0 0 
0 0 0 0 0 0 0 0 0 0 0 0 0 0 0 0 0 0 
0 0 0 0 0 0 0 0 0 0 0 0 0 0 0 0 0 0 
0 0 0 0 0 0 0 0 0 0 0 0 0 0 0 0 0 0 
0 0 0 0 0 0 0 0 0 0 0 0 0 0 0 0 0 0 
0 0 0 0 0 0 0 0 0 0 0 0 0 0 0 0 0 0 
0 0 0 0 0 0 0 0 0 0 0 0 0 0 0 0 0 0 
0 0 0 0 0 0 0 0 0 0 0 0 0 0 0 0 0 0 
0 0 0 0 0 0 0 0 0 0 0 0 0 0 0 0 0 0 
0 0 0 0 0 0 0 0 0 0 0 0 0 0 0 0 0 0 
0 0 0 0 0 0 0 0 0 0 0 0 0 0 0 0 0 0 
0 0 0 0 0 0 0 0 0 0 0 0 0 0 0 0 0 0 
0 0 0 0 0 0 0 0 0 0 0 0 0 0 0 0 0 0 
0 0 0 0 0 0 0 0 0 0 0 0 0 0 0 0 0 0 
0 0 0 0 0 0 0 0 0 0 0 0 0 0 0 0 0 0 
0 0 0 0 0 0 0 0 0 0 0 0 0 0 0 0 0 0 
0 0 0 0 0 0 0 0 0 0 0 0 0 0 0 0 0 0 
0 0 0 0 0 0 0 0 0 0 0 0 0 0 0 0 0 0