TILEMAP
16 16 					-- Size of tile map in tiles
24 24				-- Tile size & block size
images/tilesheet.png 	-- Tilesheet
8 8		-- Number of tiles in tilesheet

23 37 30 30 44 30 30 38 38 38 38 38 39 0 0 29 
30 23 37 38 38 38 39 0 0 0 0 0 0 0 0 29 
30 30 23 45 0 0 0 0 0 0 0 0 0 0 0 29 
38 38 39 0 0 0 0 0 0 0 0 0 0 45 45 29 
23 5 6 0 0 0 0 0 0 0 0 0 46 47 22 30 
31 13 14 0 0 0 0 0 0 0 0 0 0 0 37 30 
30 22 47 47 48 0 0 0 0 0 0 0 0 0 0 29 
30 39 0 0 0 0 0 0 0 0 0 0 0 0 0 29 
31 0 0 0 0 0 0 0 0 0 0 0 0 0 0 29 
39 0 0 0 0 0 0 0 0 0 0 0 0 46 22 30 
0 0 0 0 0 0 0 0 0 0 0 0 0 0 29 30 
0 0 0 0 0 0 0 21 23 0 0 0 0 0 29 30 
0 0 0 21 23 0 0 37 39 0 0 4 4 4 29 30 
22 22 22 30 31 0 0 21 23 4 4 21 22 22 30 30 
30 44 30 30 31 4 4 29 30 22 22 30 30 30 44 30 
30 30 30 30 30 22 22 30 30 30 30 30 30 30 30 30 
