TILEMAP
18 198					-- Size of tile map in tiles
24 24				-- Tile size & block size
images/tilesheet.png 	-- Tilesheet
8 8		-- Number of tiles in tilesheet
0 0 0 0 0 0 0 0 0 0 0 0 0 0 0 0 0 0 
0 23 37 30 30 44 30 30 38 38 38 38 38 39 55 55 29 0 
0 30 23 37 38 38 38 39 0 0 0 0 0 0 0 0 29 0 
0 30 30 23 45 0 0 0 0 0 0 0 0 0 0 0 29 0 
0 38 38 39 0 0 0 0 0 0 0 0 0 0 45 45 30 0 
0 23 21 23 0 0 0 0 0 0 0 0 0 46 47 22 30 0 
0 31 37 39 0 0 0 0 0 0 0 0 0 0 0 37 30 0 
0 30 22 47 47 48 0 0 0 0 0 0 0 0 0 0 29 0 
0 30 39 0 0 0 0 0 0 0 0 0 0 0 0 0 29 0 
0 31 0 0 0 0 0 0 0 0 0 0 0 0 0 0 29 0 
0 39 0 0 0 0 0 0 0 0 0 0 0 0 46 22 30 0 
55 0 0 0 0 0 0 0 0 0 0 0 0 0 0 29 30 0 
55 0 0 0 0 0 0 0 21 23 0 0 0 0 0 29 30 0 
55 0 0 0 21 23 0 0 37 39 0 0 4 4 4 29 30 0 
0 22 22 22 30 31 0 0 21 23 4 4 21 22 22 30 30 0 
0 30 44 30 30 31 4 4 29 30 22 22 30 30 30 44 30 0 
0 30 30 30 30 30 22 22 30 30 30 30 30 30 30 30 30 0 
0 0 0 0 0 0 0 0 0 0 0 0 0 0 0 0 0 0 
0 0 0 0 0 0 0 0 0 0 0 0 0 0 0 0 0 0 
0 30 31 29 30 30 31 37 38 38 38 30 31 55 55 55 29 0 
0 30 31 37 38 38 0 0 0 0 0 29 31 0 0 0 29 0 
0 30 30 23 45 0 0 0 0 0 0 29 31 0 0 0 29 0 
0 44 30 31 0 0 0 0 0 0 0 29 39 0 0 0 29 0 
0 30 44 31 0 0 0 0 0 0 0 32 0 0 0 0 29 0 
0 30 38 39 0 0 0 0 4 0 0 40 0 0 0 0 29 0 
0 31 0 0 0 0 0 0 24 0 0 0 0 0 0 21 30 0 
0 30 23 45 45 0 0 0 32 0 0 0 0 0 0 29 44 0 
0 30 30 22 23 0 0 0 40 0 0 0 0 0 0 37 38 0 
0 30 30 44 31 0 0 0 45 0 0 0 0 0 0 21 22 0 
0 44 30 30 31 0 0 0 24 0 0 0 0 0 46 38 30 0 
0 38 38 30 31 0 0 0 32 0 0 0 0 0 0 0 29 0 
55 0 0 37 31 0 0 0 32 0 0 0 0 0 0 0 37 0 
55 0 0 0 40 0 0 0 32 4 4 4 0 0 0 0 0 55 
55 0 0 0 0 0 0 0 29 22 22 23 0 0 0 0 0 55 
0 22 22 22 22 22 22 22 30 30 44 31 0 0 0 0 0 55 
0 0 0 0 0 0 0 0 0 0 0 0 55 55 55 55 55 0 
0 0 0 0 0 0 0 0 0 0 0 0 0 0 0 0 0 0 
0 30 30 30 30 30 30 38 39 55 55 55 55 37 30 30 30 0 
0 30 44 30 30 30 31 0 0 0 0 0 0 0 29 44 30 0 
0 30 30 30 44 30 39 0 0 0 0 0 0 0 37 30 30 0 
0 30 38 30 30 31 0 0 0 0 0 0 0 0 0 37 30 0 
0 39 0 37 30 39 0 0 0 0 0 0 0 0 0 0 37 0 
55 0 0 0 40 21 22 23 0 0 0 0 0 0 0 0 0 55 
55 0 0 0 0 29 30 31 4 4 4 4 0 0 0 0 0 55 
55 0 0 0 0 37 38 38 47 47 47 48 0 0 0 0 0 55 
55 0 0 0 0 0 0 0 0 45 45 0 0 0 0 21 22 0 
55 0 0 0 0 0 0 0 0 0 0 0 0 0 0 29 30 0 
55 0 0 0 0 0 0 0 0 0 0 0 0 0 0 29 30 0 
55 0 0 0 0 0 0 0 4 4 4 4 0 0 0 29 44 0 
55 0 0 0 0 0 0 0 46 22 22 48 0 0 0 29 30 0 
55 0 0 0 0 0 0 0 0 29 31 0 0 0 0 29 30 0 
0 22 22 23 0 0 0 0 0 29 31 0 0 0 0 29 30 0 
0 30 44 31 0 0 24 0 0 29 31 0 0 0 21 30 30 0 
0 0 0 0 55 55 0 55 55 0 0 55 55 55 0 0 0 0 
0 0 0 0 0 0 0 0 0 0 0 0 0 0 0 0 0 0 
0 38 38 38 38 39 55 55 55 37 38 38 38 38 38 38 38 0 
55 0 0 0 0 0 0 0 0 0 0 0 0 0 0 0 0 55 
55 0 0 0 0 0 0 0 0 0 0 0 0 0 0 0 0 55 
55 0 0 0 0 0 21 22 23 0 0 0 0 0 0 0 0 55 
55 0 0 0 0 0 37 30 31 45 0 0 0 0 0 0 0 55 
55 0 0 0 0 0 0 29 31 0 0 0 0 0 0 0 0 55 
55 0 0 0 0 0 0 37 39 0 0 0 0 0 0 0 0 55 
55 0 0 0 0 0 0 21 23 0 0 0 0 0 0 0 0 55 
55 0 0 0 0 0 0 29 31 0 0 0 0 0 0 0 0 55 
55 0 0 0 0 0 0 29 31 0 0 0 0 0 0 0 0 55 
55 0 0 0 0 0 0 29 31 0 0 0 0 0 0 0 0 55 
55 0 0 0 0 0 0 37 39 0 0 0 0 0 0 0 0 55 
55 0 0 0 0 0 0 0 0 0 0 0 0 0 0 0 0 55 
0 22 22 22 23 0 0 0 0 0 0 0 0 0 0 0 0 55 
0 30 30 30 31 0 0 0 0 0 0 0 0 0 0 0 0 55 
0 30 30 44 31 0 0 0 0 0 0 0 0 0 0 0 0 55 
0 0 0 0 0 55 55 55 55 55 55 55 55 55 55 55 55 0 
0 0 0 0 0 0 0 0 0 0 0 0 0 0 0 0 0 0 
0 38 39 55 55 55 29 38 38 38 39 37 38 38 38 30 30 0 
55 0 0 0 0 0 40 0 0 0 0 0 0 0 0 37 44 0 
55 0 0 0 0 0 0 0 0 0 0 0 0 0 0 0 29 0 
55 0 0 0 46 47 48 0 0 0 0 0 0 0 0 0 29 0 
55 0 0 0 0 0 0 0 0 0 0 4 4 0 0 0 37 0 
55 0 0 0 0 0 0 0 0 0 0 21 23 0 0 0 0 55 
55 0 0 0 0 0 0 4 4 0 0 29 31 0 0 0 0 55 
55 0 0 0 0 0 0 46 48 0 0 29 31 0 0 0 0 55 
55 0 0 0 0 0 0 45 0 0 0 37 30 23 0 0 0 55 
55 0 0 0 0 0 0 24 0 0 0 0 37 39 0 0 0 55 
55 0 0 0 0 0 0 40 0 0 0 0 0 0 0 0 0 55 
55 0 0 0 0 0 0 45 0 0 0 0 0 0 0 0 0 55 
0 47 47 47 48 0 0 45 0 0 0 0 0 0 0 0 0 55 
0 0 0 45 0 0 0 45 0 0 0 0 46 47 47 47 47 0 
0 0 0 45 0 0 0 24 0 0 0 0 0 45 0 0 0 0 
0 0 0 45 0 0 0 32 0 0 0 0 0 45 0 0 0 0 
0 0 0 0 55 55 55 0 55 55 55 55 55 0 0 0 0 0 
0 0 0 0 0 0 0 0 0 0 0 0 0 0 0 0 0 0 
0 30 30 30 44 30 30 30 30 30 30 30 31 55 55 29 30 0 
0 30 30 30 30 30 44 30 30 38 38 38 39 0 0 29 30 0 
0 30 30 38 38 38 38 38 39 21 22 22 23 0 0 29 30 0 
0 30 31 21 22 23 45 21 23 37 38 38 39 0 0 29 30 0 
0 38 39 29 30 31 0 37 39 45 0 0 0 0 0 29 30 0 
55 0 0 37 38 39 0 0 0 0 0 0 0 0 0 29 30 0 
55 0 0 4 4 4 0 0 0 0 0 0 0 0 21 30 44 0 
55 0 0 0 0 0 0 0 0 0 0 0 0 0 37 38 38 0 
55 0 0 0 0 0 0 0 0 0 0 0 0 0 0 0 0 55 
55 0 0 0 0 0 0 0 0 0 0 0 0 0 0 0 0 55 
55 0 0 0 0 0 0 0 0 0 0 0 0 0 0 0 0 55 
55 0 0 0 0 0 0 0 0 0 0 0 0 0 0 0 0 55 
0 22 22 23 0 0 0 0 0 0 0 0 0 0 0 0 0 55 
0 30 30 30 22 22 22 23 0 0 0 0 0 0 0 21 22 0 
0 30 44 30 30 30 30 31 0 0 0 21 22 22 22 30 30 0 
0 30 30 30 30 44 30 31 0 0 0 29 30 30 30 44 30 0 
0 0 0 0 0 0 0 0 55 55 55 0 0 0 0 0 0 0 
0 0 0 0 0 0 0 0 0 0 0 0 0 0 0 0 0 0 
0 30 44 30 30 30 31 55 55 55 55 29 30 44 30 30 30 0 
0 30 30 44 30 38 39 0 0 0 0 37 38 30 30 44 30 0 
0 30 30 38 39 0 0 0 0 0 0 0 0 37 38 30 30 0 
0 44 31 4 0 0 0 0 0 0 0 0 0 0 4 29 30 0 
0 30 31 4 0 0 0 0 0 0 0 0 0 0 4 29 30 0 
0 30 39 4 0 0 0 0 4 4 0 0 0 0 4 37 44 0 
0 31 0 0 0 0 0 4 45 45 4 0 0 0 0 0 29 0 
0 31 0 0 0 0 0 0 0 0 0 0 0 0 0 0 29 0 
0 39 0 0 0 0 0 0 0 0 0 0 0 0 0 0 37 0 
55 0 0 0 0 0 0 0 0 0 0 0 0 0 0 0 0 55 
55 0 0 0 0 0 0 0 0 0 0 0 0 0 0 0 0 55 
55 0 0 0 0 0 0 0 0 0 0 0 0 0 0 0 0 55 
55 0 0 0 0 0 0 0 0 0 0 0 0 0 0 0 0 55 
55 0 0 0 0 0 0 0 0 0 0 0 0 0 0 0 0 55 
55 0 0 0 0 0 0 0 0 0 0 0 0 0 0 0 0 55 
55 0 21 22 23 0 0 0 0 0 0 0 0 0 0 0 0 55 
0 55 0 0 0 55 55 55 55 55 55 55 55 55 55 55 55 0 
0 0 0 0 0 0 0 0 0 0 0 0 0 0 0 0 0 0 
0 31 55 55 55 55 37 38 38 38 30 44 30 30 30 30 30 0 
0 31 0 0 0 0 0 0 0 0 37 38 38 38 38 30 30 0 
0 31 0 0 0 0 0 0 0 0 0 0 0 0 0 29 44 0 
0 31 0 0 0 0 0 0 0 0 0 0 0 0 0 29 30 0 
0 31 0 0 0 0 0 0 0 0 0 0 0 0 0 29 30 0 
0 31 4 0 0 0 0 0 0 0 0 0 0 0 0 29 30 0 
0 30 23 0 0 0 0 0 0 0 0 0 0 0 0 37 38 0 
0 30 39 0 0 0 0 0 0 0 0 0 0 0 0 0 0 55 
0 39 0 0 0 0 0 0 0 0 0 0 0 0 0 0 0 55 
55 0 0 0 0 0 0 0 0 0 0 0 0 0 0 0 0 55 
55 0 0 0 0 0 0 0 0 0 0 0 0 0 0 0 0 55 
55 0 0 0 0 0 0 0 0 0 0 0 0 0 0 0 0 55 
55 0 0 0 0 0 0 0 0 0 0 0 0 0 0 0 0 55 
55 0 0 0 0 0 0 0 0 0 0 0 0 0 0 0 0 55 
55 0 0 0 0 0 0 0 0 0 0 0 0 0 0 0 0 55 
0 22 22 22 23 0 0 0 0 0 0 0 0 0 0 0 0 55 
0 0 0 0 0 55 55 55 55 55 55 55 55 55 55 55 55 0 
0 0 0 0 0 0 0 0 0 0 0 0 0 0 0 0 0 0 
0 30 38 39 55 55 55 29 38 38 38 38 38 38 38 30 30 0 
0 31 0 0 0 0 0 32 5 6 0 0 0 0 0 29 30 0 
0 39 0 0 0 0 0 40 13 14 0 0 0 0 0 29 30 0 
55 0 0 0 0 0 0 0 0 0 0 0 0 0 0 29 44 0 
55 0 0 0 0 0 0 0 0 0 0 0 0 0 0 29 30 0 
55 0 0 0 0 0 0 0 0 0 0 0 0 0 0 29 30 0 
55 0 0 0 0 0 0 0 0 0 0 0 0 0 0 29 30 0 
55 0 0 0 0 0 0 0 0 0 0 0 0 0 0 37 38 0 
55 0 0 0 0 0 0 0 0 0 0 0 0 0 0 0 0 55 
55 0 0 0 0 0 0 0 0 0 0 0 0 0 0 0 0 55 
55 0 0 0 0 0 0 0 0 0 0 0 0 0 0 0 0 55 
55 0 0 0 0 0 0 0 0 0 0 0 0 0 0 0 0 55 
55 0 0 0 0 0 0 0 0 0 0 0 0 0 0 0 0 55 
55 0 0 0 0 0 0 0 4 4 4 0 0 0 0 0 0 55 
0 4 4 45 4 4 4 4 21 22 23 0 0 0 0 0 0 55 
0 22 22 22 22 22 22 23 29 44 31 4 4 4 45 45 4 0 
0 30 44 30 30 30 30 31 29 30 31 21 22 22 22 22 22 0 
0 0 0 0 0 0 0 0 0 0 0 0 0 0 0 0 0 0 
0 0 0 0 0 0 0 0 0 0 0 0 0 0 0 0 0 0 
0 30 30 31 55 55 55 55 29 30 38 38 38 38 30 44 30 0 
0 30 44 31 0 0 0 0 37 39 0 0 0 0 37 38 30 0 
0 30 30 31 0 0 0 0 45 0 0 0 0 0 0 0 37 0 
0 30 30 31 0 0 0 0 45 0 0 0 0 0 0 0 0 55 
0 30 30 31 24 0 0 0 45 0 0 0 0 0 0 0 0 55 
0 44 30 31 40 0 0 0 0 0 0 0 0 0 0 0 0 55 
0 38 38 39 45 0 0 0 0 0 0 0 0 0 24 0 0 55 
0 47 47 47 48 4 4 0 0 0 0 0 0 4 32 0 0 55 
55 0 0 0 46 48 45 0 0 0 0 0 0 45 32 0 0 55 
55 0 0 0 0 0 0 0 0 0 0 0 0 0 40 0 0 55 
55 0 0 0 0 0 0 0 0 0 0 0 0 0 0 0 0 55 
55 0 0 0 0 0 0 0 0 0 0 0 0 0 0 0 0 55 
55 0 0 0 0 0 0 0 0 0 0 0 0 0 0 0 0 55 
55 0 0 0 0 0 0 0 0 0 0 0 0 0 0 0 0 55 
55 0 24 0 0 0 0 0 0 0 0 0 0 0 0 0 0 55 
55 0 32 0 0 0 0 0 0 0 0 0 0 0 0 0 0 55 
0 55 0 55 55 55 55 55 55 55 55 55 55 55 55 55 55 0 
0 0 0 0 0 0 0 0 0 0 0 0 0 0 0 0 0 0 
0 30 38 38 38 38 38 38 38 30 31 55 55 55 29 44 30 0 
0 31 0 0 0 0 0 0 0 37 39 0 0 0 29 30 30 0 
0 39 0 4 4 4 0 0 0 0 0 0 0 0 37 30 30 0 
55 0 0 21 22 23 0 0 0 0 0 0 0 0 0 29 30 0 
55 0 46 30 30 39 0 0 0 0 0 0 0 4 4 29 30 0 
55 0 4 29 31 0 0 0 0 0 0 0 4 21 22 30 30 0 
55 0 4 29 31 0 0 0 0 0 0 0 4 37 30 44 30 0 
55 0 4 37 39 0 0 0 0 0 0 0 0 0 37 38 30 0 
55 0 0 0 0 0 0 4 4 0 0 0 0 0 0 0 37 0 
0 4 4 4 4 4 4 21 48 0 0 0 0 0 0 0 0 55 
0 22 47 47 47 47 47 39 0 0 0 0 0 0 0 0 0 55 
0 39 0 0 0 0 0 0 0 0 0 0 0 0 0 0 0 55 
55 0 0 0 0 0 0 0 0 0 0 0 0 0 0 0 0 55 
55 0 0 0 0 0 0 0 0 0 0 0 0 0 0 0 0 55 
55 0 0 0 0 0 0 0 0 0 0 0 0 0 0 0 0 55 
0 55 55 55 55 55 55 55 55 55 55 55 55 55 55 55 55 0